1134003340
2223331120
0040043120
0022211330
2143210110
