1144423122
1234321022
1133422022
0011232422
1244332211