1134003300
2223331100
0040043000
0022200330
2143210100
