1134003300
2223331100
0000043000
0022200000
2143210000
