1134003300
2223331100
0000000000
0000000000
2143210000
1110010000
1110000000
